******************************
*   *    *                   *
*             *        *     *
*   *    *     *      *      *
*               *    *       *
*   *    *       *  *        *
*                            *
*******                *     *
*     *          *******     *
*     *                *     *
*     *                *     *
*     *             **********
*          *****             *
*            *               *
*** ***      *    *******    *
*     *           *          *
*     *********   *      *****
*     *           *          *
*     *           *          *
******************************