******************************
*                            *
* *                       *  *
*  *                     *   *
*   *    **********     *    *
*    *                 *     *
*     *               *      *
*      *             *       *
*                            *
*   ****            ****     *
*                            *
*                            *
*      *             *       *
*     *               *      *
*    *                 *     *
*   *    **********     *    *
*  *                     *   *
* *                       *  *
*                            *
******************************