******************************
*       *                    *
*       *                    *
*       *                    *
*       *                    *
*       *                    *
*       *                    *
*       *        *************
*                            *
*                            *
*                            *
*                            *
*                            *
*                            *
*                  *         *
*                  *         *
***********        *         *
*                  *         *
*                  *         *
******************************