******************************
*                            *
*                            *
*********************     ****
*                            *
*                            *
*                            *
*                            *
************    **************
*                            *
*                            *
*                            *
*                            *
*****    *********************
*                            *
*                            *
*********************   ******
*                            *
*                            *
******************************