******************************
*                            *
*  *******          *******  *
*  *     *          *     *  *
*  *     *          *     *  *
*  *     *          *     *  *
*  *     *          *     *  *
*                            *
*  *******          *******  *
*  *                      *  *
*  *                      *  *
*  *                      *  *
*  *******          *******  *
*                            *
*  *     *          *     *  *
*  *     *          *     *  *
*  *     *          *     *  *
*  *******          *******  *
*                            *
******************************